mm____m___mmmmm
DmAmm___m______
__m_m_m_m__m_m_
m____m_m_m_m_m_
mmmm_m_m_m_mmm_
______m_mm____m
_mmmmm_m_mmmm_m
______m_m_m___m
mmmmm_m_m_m_m_m
______m_m_m_m_m
_mm_m_m_mmm_m_m
_____m_m_______
m_m_mmm_m_m_m_m
__mm____m_m_m_m
m____mm____m_m_
