___m___m_______
Dm___m___m_m_m_
m_mmm_m_mmm_mm_
____mmmm_______
mmm_m_mm_mm_mmm
______mm__m____
m_m_m__mm_mmmm_
__m__mAm_m_____
m_mmmmm_m__mm_m
m__mmm_m__mmm_m
___m_m_m_m__m_m
m___mmm__m_m__m
mmm_mm___mmm_mm
mmm____mmm_m_m_
mmmmmmmmmmmmmmm
